00000000000001100111111111101111111111111111111111
00000000000001000111111111101111111111111111111111
00000000000111111101011111101111111111111111111111
00000000000011000001111111101111111111111111111111
00000000000000000000100010000000000000011111111111
00000000000000000000000000000000000000011111111111
00000000000000000000000000000000000000011111111111
00000000000000000000000000000000000000011111111111
00000000000000000000000000000000000000011111111111
00000000000000000000000000000000000000011111111111
10000000000000000000000000000000000000011111111111
10000000000000000000000000000000000000011111111111
00000000000000000000000000000000000000011011111111
00000000000000000000000000000000000000011111111111
00000000000000000000000000000000000000011111111111
00000000000000000000000000000000000000000001111111
00000000000000000000000000000000000000000001111111
00011111111111100000000000000000000000000001111111
00011111111111100000000000000000000000000001111111
00011111111111100000000000000000000000000111111111
00011111111111100000000000000000000000000111111111
00011111111111100000000000000000000000000001111111
00011111111111100000000000000000000000000001111111
00011111111111100000000000000000011111100001111111
00011111111111100000000000000000011111100001111111
00011111111111100000000000000000011111100001111111
00011111111101100000000000000000011111100001111111
00011111111111100000000000000000011111100001111111
00011111111111100000000000000000011111100001111111
00011111111111100000000000000000011111100001111111
00011111111111100000000000000000011111101111111111
00011111111111100000000000000000011111101000111111
00011111111111100000000000000000011111101000111111
00011111100111100000000011111100011111101111111111
00011111100111100000000001110100011111101111111111
00011111100001100000000011111100011111101111111111
00011111100001100000000011111100011111101111111111
00011111100000000000000011111100011111101111111111
00011111100000000000000011111100011111101111111111
00011111111111100000000011111100011111101111111111
00011111111111100000000011111100011111101111111111
00011111111111100000000011111100011111101111111111
00011111111111100000000011111100011111101111111111
00000000000000000000000011111100000000001111111111
00000000000000000000000011111100001111111111111111
00000000000000000000000011111100001111111111111111
00000000000000000000000011111100001111111111111111
00000000000000000000000000000000001111111111111111
00000000000000000000000000000000001111111111111111
00000000000000000000000000000000001111111111111111
00000000000000000000000000000000000000000000000000
00000000000000000000000000000000000000000000000000
00000000000000000000000000000000000000000000000000
00000000000000000000000000000000000000000000000000
00100000000000000000000011111100001111111100000000
01110000000000000000000011110100001111111100001111
01110000000000000000000011111111111111111100001111
00000000000000000000000011111111111111111100001111
00000000000000000000000011111111111111111100001111
00000000000000000000000011111111111111111100001111
00000000000000000000000011111111111111111100001111
00111000000000000000000011111111111111111100001111
00111000000000000000000011111111111111111100001111
00000000000000000000000011111111111111111100001111
00000000000000000000000011111111111111111100001111
00000111111111111111000011111111111111111100001111
00000111111111111111000011110000111111111100001111
00000111111111111111000011110000111111111100001111
00000111111111111111000011110000001111111100001111
00000111111111111111000011110000001111111100001111
00000111111111111111000011110000001111111100001111
00000111111111111111000011110000001111111100000000
00000111111111111111000011110000001111111100000000
00000111111111111111000011110000001111111100000000
00000111111111111111000000000000000000000000000000
00000111111111111111000000000000000000000000000000
00000000001110000000000000000000000000000000000000
00000000000000000000000000000000000111111111111111
00000000000000000000000000000000000111111111111011
00000000000000000000000000000000000111111111111111
00000000000000000000000000000000000111111111111111
00000000000000000000000000000000000111111111111111
00000000000000000000000000000000000111111111111111
00000000000000000000000000000000011111111111111111
00000000000000000000000000000000011111111111111111
00000000000000000000000000000001111111111111111111
00000000000000000000000000000001111111111111111111
00000000000000000000000000000111111111111111111111
00011111111000000000000000000111111111111111111111
00000001111111000000000000000111111111111111111111
00000000000001000000000000000111111111111111111111
00000000000001000000000000011111111111111111111111
00000000000001000000000000011111111111111111111111
00000000000001100000000000011111111111111111111111
00000000011111100000000000011111111111111111111111
00000000011111000000000000011111110111111111111111
00000000011111000100000000011111111111011101111011
00000000011111000000000000011111111111111111111111
00000000000000000000000000011111101111111111111111
00000000000000000000000000011111111111111111111111
