10111111111111111111111111111111111111111111110001
11111100000000000000000000000000000001111011110001
11110000000000000000000000000000000001111111110001
11100000000000000000000000000000000001111111110001
11100000000000000000000000000000000001111111110001
10000000000000000000000000000000000001111111110001
10000000000000000000000000000000000001111111110001
00000000000000000000000000000000000001111111110001
00000000000000000000000000000000000001111111110001
00000000000000000000000000000000000001111111110001
00000000000000000000000000000000000001111111110001
00000000000000000000000000000000000001111110110001
00000000000000000000000000000000000000000110110001
00000000000000000000000000000000000000000001110001
00000000000000000000000000000000000000000001110001
00000000000000000000000000000000000000000001110011
00000000000000000000000000000000000000000000000011
00000000000000000000000000000000000000000000000011
00000000000000000000000000000000000000000000000011
00000000000000000000000000000000000000000000000011
00000000000000000000000000000000000000000000000001
00000000000000000000000000000000000000000000000001
00000000000000000000000000000000000000000000000001
00000000000000000000000000000000000000000000000001
00000000000000000000000000000000000000000000000000
00000000000000000000000000000000000000000000000000
00000000000000000000000000000000000000000000000000
00000000000000000000000000000000000000000000000000
00000000000000000000000000000000000000000000000000
00000000000000000000000000000000000000000000000000
