PONEYYYYYYYYYYYYYY
0
400
240
physique
50
31
11111111111111111111111111111111111111111111110001
11111100111000000111111111111111111111111111110001
11110000000000000111111111111111111111111111110001
11100000000000011111111111111111111111111111110001
11000000000000011111111111111110000111111111110001
10000000000000011111111111111110000111111111110001
10000000000000011111111111111111100111111111110001
11000000000000011111111111111111100111111111110001
11000000000000011111111111111111100111111111110001
11000000000000011111111111111111100111111111110001
11110000000000011111111111111101100111111111110001
11111100000000011111111111111100000001111111110001
11111111100000000000000000000000000001111111110001
00000000000000000000000000111110000000000111110001
00000000000000000000011100111110000000000111110001
00000000000001111100011100111110000000000001110011
00111110000001111100011100111010000001111001110011
00111110000001111100000000111110000001111000000011
00111110000001111100111100000010000111111110000011
00111110000001000000111100111000000111111110010011
00000000000000000000111100111000000111111111110001
00000000000000000000111100111000000111111111110001
00000111111111000000100000000000011111111111110001
00000111111111000000000000000000011111111111110001
00000111111111000000001000100000011111111111111111
11111111111111111111111000111111111111111111111111
11111111111111111111111000111111111111111111111111
11111111111111100000001000101111111111111111111111
11111001101100000000000000001111111111111111111111
11111100000000000000000000001111111111111111111111
11111111111111111111111111111111111111111111111111
eau
00000000111111111111111111111111111111111111110000
00000000000000000111111111111111111111111111110000
00000000000000000111111111111111111111111111110000
00000000000000011111111111111110000111111111110000
00000000000000011111111111111110000111111111110000
00000000000000011111111111111110000111111111110000
00000000000000011111111111111111100111111111110000
00000000000000011111111111111111100111011111110000
00000000000000011111111111111111100111111111110000
00000000000000011111111111111101100111101101110000
00000000000000011111111111111100000001111111110000
00000000000000000000000000000000000001111111110000
00000000000000000000000000000000000000000111110000
00000000000000000000000000111110000000000111110000
00000000000000000000000000111110000000000001110000
00000000000001111100000000111110000000000001110011
00111110000001111100000000111110000001111000000011
00111110000001111100000000000010000001011000000011
00111110000001000000111100000000000111111110000011
00000000000000000000111100000000000111111110010011
00000000000000000000111100000000000111111111110000
00000000000000000000100000000000000111111111110000
00000111111111000000000000000000011111111111110000
00000111111111000000000000000000011111111111110000
00000111111111000000001000100000000000000000000000
00000111111111000000001000100000000000000000000000
00000111111111100000001000100000000000000000000000
00001111111111100000001000100000001110000000000000
00001000000000000000000000000000001110000000000000
00000000000000000000000000000000000000000000000000

//
spawn
100
100
0
0
100
10

150
100
0
1
100
10
new
//
caisses

250
30

635
210

500
250
//
barrels

115
303
barrel

490
383
barrel

225
175
barrel
//
arrivee
0
0
//
bossentry
144
445
//