1
80
1584
physique
50
101
11111111111111111111111111101111111111111111111111
11111111111111111111111111101111111111111111111111
11111111111111011101111111101111111111111111111111
11111111111011000001111111101111111111111111111111
11111111111000000001111111100000000000011111111111
11111111111000000000111110000000000000011111111111
11111111111000000000000000000000000000011111111111
11111111111000000000000000000000000000011111111111
11111111111000000000000000000000000000011111111111
11111111111000000000000000000000000000011111111111
11111111111000000000000000000000000000011111111111
11111111111111111110000000000000000000011111111111
11111111111111111110000000000000000000011111111111
11111111111111111110000000000000000000011111111111
11111111111111111111100000000000000000011111111111
11111111111111111111100000000000000000000001111111
11000000000000000011100000000000000000000001111111
11011111111111100011100011110000000000000001111111
11011111111111100011000011110000000000001111111111
11011111111111100011000011110000000000011111111111
11011111111111100011000011110000000000011111111111
11011111111111100000000000000000000000111111111111
11011111111111100000000000000000000001111111111111
11011111111111100000000000000000011111111111111111
11011111111111100000000000000000011111111111111111
11011111111111100000000000000000011111111111111111
11011111111111100000000000000000011111111111111111
11011111111111100000000000000000011111111111111111
11011111111111100000000000000000011111111111111111
11011111111111100000000000000000011111111111111111
11011111111111100000000000000000011111111111111111
11011111111111100000000000000000011111111111111111
11011111111111100000000000000000011111111111111111
11011111111111100000000011111100011111111111111111
11011111111111111111000011111100011111111111111111
11011111111111111111000011111100011111111111111111
11011111111111111111000011111100011011111111111111
11011111111111111111000011111100011111111111111111
11011111111111111111000011111100011111111111111111
11011111111111111111000011111100011111111111111111
11011111111111111111000011111100011111111111111111
11011111111111111111000011111100011111111111111111
11011111111111111111000011111100011111111111111111
11011111111111100000000011111100011111111111111111
11000000000000000000000011111100001111111111111111
11000111100000000000000011111100001111111111111111
11000111100000000000000011111100001111111111111111
11000111100000000000000011111100001111111111111111
11000111100000000000000000000000001111111111111111
11000111100000000000000000000000001111111111111111
11111111100000000000000000000000001111110000000000
11111111100000000000000000000000000000000000000000
11111111100000000000000000000000000000000000000000
11111111100000000000000000000000000000000000000000
11111111100000000000000011111100001111111100000000
11111110000000000000000011111100001111111100001111
11111110011110000000000011111111111111111100001111
11111110011110000000000011111111111111111100001111
11111110000011111100000011101111111111111100001111
11111110000011111100000011111111111111111100001111
11111110000000111011111111111111111111111100001111
11111000000000111011111111111111111111111100001111
11111000000000111011111111111111111111111100001111
11111000000000111011111111111111111111111100001111
11000000000000000011111111111111111111111100001111
11000111111111111111000011111111111111111100001111
11000111111111111111000011111111111111111100001111
11000111111111111111000011110000111111111100001111
11000111111111111111000011110000111111111100001111
11000111111111111111000011110000001111111100001111
11000111111111111111000011110000001111111100001111
11000111111111111111000011110000001111111100001111
11000111111111111111000011110000001111111100000000
11100111111111110111000011110000001111111100000000
11100111111111111111000011110000001111111100000000
11000111111111111111000000000000000000000000000000
11000111111111111111000000000000000000000000000000
11000000001110000000000000000000000111111111111111
11000000000000000000000000000000000111111111111111
11000000000000000000000000000000000111111111111111
11000000000000000000000000000000000111111111111111
11000000000000000000000000000000000111111111111111
11100000000000000000000000000000000111111111111111
11100000000000000000000000000000011111111111111111
11100000000000000000000000000000011111111111111111
11100000000000000000000000000001111111111111111111
11100000000000000000000000000001111111111111111111
11100000000000000000000000000111111111111111111111
11111111111000000000000000000111111111111111111111
11111111111111000000000000000111111111111111111111
11111111111111000000000000000111111111111111111111
11111111111111000000000000011111111111111111111111
11111111111111000000000000011111111111111111111111
11111111111111100000000000011111111111111111111111
11111111111111100000000000011111111111111111111111
11111111111111111100000000011111111111111111111111
11111111111111111100000000011111111111111111111111
11111111111111110100000000011111111111111111111111
11100000011111000000000000011111111111111111111111
11100000000000000000000000011111111111111111111111
11111111111111111111111111111111111111111111111111
eau
11111111111111111111111111101111111111111111111111
11111111111111111111111111101111111111111111111111
11111111111111011101111111101111111111111111111111
11111111111011000001111111101111111111111111111111
11111111111000000001111111100000000000011111111111
11111111111000000000111110000000000000011111111111
11111111111000000000000000000000000000011111111111
11111111111000000000000000000000000000011111111111
11111111111000000000000000000000000000011111111111
11111111111000000000000000000000000000011111111111
11111111111000000000000000000000000000011111111111
11111111111111111110000000000000000000011111111111
11111111111111111110000000000000000000011111111111
11111111111111111110000000000000000000011111111111
11111111111111111111100000000000000000011111111111
11111111111111111111100000000000000000000001111111
11000000000000000011100000000000000000000001111111
11011111111111100011100011110000000000000001111111
11011111111111100011000011110000000000001111111111
11011111111111100011000011110000000000011111111111
11011111111111100011000011110000000000011111111111
11011111111111100000000000000000000000111111111111
11011111111111100000000000000000000001111111111111
11011111111111100000000000000000011111111111111111
11011111111111100000000000000000011111111111111111
11011111111111100000000000000000011111111111111111
11011111111111100000000000000000011111111111111111
11011111111111100000000000000000011111111111111111
11011111111111100000000000000000011111111111111111
11011111111111100000000000000000011111111111111111
11011111111111100000000000000000011111111111111111
11011111111111100000000000000000011111111111111111
11011111111111100000000000000000011111111111111111
11011111111111100000000011111100011111111111111111
11011111111111111111000011111100011111111111111111
11011111111111111111000011111100011111111111111111
11011111111111111111000011111100011011111111111111
11011111111111111111000011111100011111111111111111
11011111111111111111000011111100011111111111111111
11011111111111111111000011111100011111111111111111
11011111111111111111000011111100011111111111111111
11011111111111111111000011111100011111111111111111
11011111111111111111000011111100011111111111111111
11011111111111100000000011111100011111111111111111
11000000000000000000000011111100001111111111111111
11000111100000000000000011111100001111111111111111
11000111100000000000000011111100001111111111111111
11000111100000000000000011111100001111111111111111
11000111100000000000000000000000001111111111111111
11000111100000000000000000000000001111111111111111
11111111100000000000000000000000001111110000000000
11111111100000000000000000000000000000000000000000
11111111100000000000000000000000000000000000000000
11111111100000000000000000000000000000000000000000
11111111100000000000000011111100001111111100000000
11111110000000000000000011111100001111111100001111
11111110011110000000000011111111111111111100001111
11111110011110000000000011111111111111111100001111
11111110000011111100000011101111111111111100001111
11111110000011111100000011111111111111111100001111
11111110000000111011111111111111111111111100001111
11111000000000111011111111111111111111111100001111
11111000000000111011111111111111111111111100001111
11111000000000111011111111111111111111111100001111
11000000000000000011111111111111111111111100001111
11000111111111111111000011111111111111111100001111
11000111111111111111000011111111111111111100001111
11000111111111111111000011110000111111111100001111
11000111111111111111000011110000111111111100001111
11000111111111111111000011110000001111111100001111
11000111111111111111000011110000001111111100001111
11000111111111111111000011110000001111111100001111
11000111111111111111000011110000001111111100000000
11100111111111110111000011110000001111111100000000
11100111111111111111000011110000001111111100000000
11000111111111111111000000000000000000000000000000
11000111111111111111000000000000000000000000000000
11000000001110000000000000000000000111111111111111
11000000000000000000000000000000000111111111111111
11000000000000000000000000000000000111111111111111
11000000000000000000000000000000000111111111111111
11000000000000000000000000000000000111111111111111
11100000000000000000000000000000000111111111111111
11100000000000000000000000000000011111111111111111
11100000000000000000000000000000011111111111111111
11100000000000000000000000000001111111111111111111
11100000000000000000000000000001111111111111111111
11100000000000000000000000000111111111111111111111
11111111111000000000000000000111111111111111111111
11111111111111000000000000000111111111111111111111
11111111111111000000000000000111111111111111111111
11111111111111000000000000011111111111111111111111
11111111111111000000000000011111111111111111111111
11111111111111100000000000011111111111111111111111
11111111111111100000000000011111111111111111111111
11111111111111111100000000011111111111111111111111
11111111111111111100000000011111111111111111111111
11111111111111110100000000011111111111111111111111
11100000011111000000000000011111111111111111111111
11100000000000000000000000011111111111111111111111
11111111111111111111111111111111111111111111111111
//
spawn
240
120
4
2
100
10
new

350
460
2
2
100
10
new
//
caisses

510
360

230
830

550
205

295
350

360
940

65
1360
//
barrels

65
1580
barrel

500
1320
barrel

240
1470
barrel

325
1320
barrel

225
1240
barrel

210
999
barrel

350
1060
barrel

495
1120
barrel

770
1200
barrel

765
830
barrel

433
785
barrel

50
780
barrel

255
520
barrel

600
275
barrel

600
100
barrel
//