PONEY
5
360
460
physique
50
31
00000000100100000000000000000000000000100000000000
00000001100100000000000000000000000000100000000000
00000010000100000000000000000000000000100000000000
00000010000100000000000000000000000000100000000000
00000010000100000000000000000001111111100000000000
00000100000100000000000000000001000000000000000000
00000100000100000000000000000001000000000000000000
00000100000100000000000000000001000000000000000000
00001000000100000000000000000001000000000000000000
00010000000100000000000000000001000000000000000000
00110000000100000000000000000001000000000000000011
01000000000111000000111111111111000000000000011100
01000000000001100000100000000000000000000000010000
10000000000000110001000000000000000000000011100000
00000000000000011010000000000000000000000010000000
00000000000000001100000000000000000000011100000000
00000000000000000100000000000000000000010000000000
00000000000000000000000000000000000011100000000000
11000000000000000000000000000000000010000000000000
01111000000000000000000000000000001100000000000000
00111100000000000000000000000000001000000000000000
00011100000000000000000000000000010000000000000000
00001000000000000000000000000000100000000000000000
00000100000000000000000000000000100000000000000000
00000100000000000000000000000011000000000000000000
00000100000000000000000000000100000000000000000000
00000010000000000000000000000100000000000000000000
00000001000000000000000000001000000000000000000000
00000000100000000000000000001000000000000000000000
00000000010000000000000000010000000000000000000000
eau
00000000000111111110111111011111111111100000000000
00000000000100000000000000000000000000100000000000
00000000000100000000000000000000000000100000000000
00000000000100000000000000000000111100100000000000
00000000000100000000000000000001110111100000000000
00000000000100000000000000000001000000000000000000
00000000000100000000000000000001000000000000000000
00000000000100000000000000000001000000000000000000
00000000000100000000000000000001000000000000000000
00000000000100000000000000000001000000000000000000
00000000000100000000111000000001000000000000000000
01000000000111111111111111111111000000000000000000
10000000000000111111000000000000000000000000000000
00000000000000011110000000000000000000000000000000
00000000000000001100000000000000000000000000000000
00000000000000000100000000000000000000000000111100
00000000000000000000000000000000000000000000111100
00000000000000000000000000000000000000001100111000
00000000000000000000000000000000000000001101111111
00011000000000000000000000000000000000001101111111
00001100000000000000000000000000000000011111011111
00000100000000000000000000000000000111110001111111
00000000000000000000000000000000000111111111111111
00000000000000000000000000000000000100000000000000
00000000000000000000000000000000000100000000000000
00000000000000000000000000000000000100000000000000
00000000000000000000000000000000000100000000000000
00000000000000000000000000000000000100000000000000
00000000000000000000000000000000000100000000000000
00000000000000000000000000000000000100000000000000

//
spawn
25
250
1
2
100
10
new

740
25
3
4
100
10
new
//
caisses

120
40

350
230

550
110
//
barrels

-100
-100
barrel
//
arrivee
0
0
//
bossentry
0
0
//