PONEYYYYYYYYYY
2
700
330
physique
50
31
11111111111111111111111111111111111111111111111111
11111111111111111111111111111111111111111111111111
11111111111111111111111111111111111111111111111111
11111111111111111111111111111111111111111111111111
11111111111111111111000111111111111111111000011111
11111111111111111111000111111111111111110000011111
11111111000000000000000011111111111111110001111111
11111111000000000000000011111111111111000001111111
11110000001111001111000000111111111111110000111111
11110000001111001111000000001111111111110000111111
11111000111111001111000000000001111111111100111111
11111000111111001111000000000001111111111100111111
11000000000000000000000000000000000000000000000011
11000000000000000000000000000000000000000000000011
11111111110001110011000111000011110011111111111111
11111111110001110011000111000011110011111111111111
11111111110000110011000000000011110011111111111111
11111111100000110011000000000000000011111111111111
11111111100000000000000110000000000000001111111111
11111110000000000000000000000011100000000000011111
11111110000000111111000000000011000000000000011111
11111110000000111111000000110011000111100000011111
11000000000000111111000011110011001111111111111111
11000000111111111111000111100000001111111111111111
11000000111111111100000111000000001111111111111111
11111011111111111111000000001111111111111111111111
11111111111111111111000000011111111111111111111111
11111111111111111111111111111111111111111111111111
11111111111111111111111111111111111111111111111111
11111111111111111111111111111111111111111111111111
eau
11111111111111111111111111111111111111111111111111
11111111111111111111111111111111111111111111111111
11111111111111111111111111111111111111111111111111
11111111111111111111000111111111111111111000011111
11111111111111111111000011111111111111111000011111
11111111000000000000000011111111111111110000011111
11111111000000000000000001111111111111000001111111
11110000000000000000000000111111111111000000011111
11110000001111001111000000001111111111110000111111
11110000001111001111000000000001111111110000111111
11111000111111001111000000000001111111111100111111
11000000000000000000000000000000000000000000000011
11000000000000000000000000000000000000000000000011
11000000000000000000000000000000000000000000000011
11111111110000000000000000000000000011111111111111
11111111110000000000000000000000000011111111111111
11111110000000000000000000000000000011111111111111
11111110000000000000000000000000000000001111111111
11111111100000000000000000000000000000000000011111
11111110000000000000000000000000000000000000011111
11111110000000111111000000000000000000000000011111
11000000000000111111000000000000000111100000011111
11000000000000111111000000000000001111111111111111
11000000111111111111000000000000001011111111111111
11000000111111111100000000000000001111111111111111
11111011111111111111000000001111111111111111111111
11111111111111111100000000011111111111111111111111
11111111111111111111111111111111111111111111111111
11111111111111111111111111111111111111111111111111
11111111111111111111111111111111111111111111111111

//
spawn
430
200
0
2
100
10
new
//
caisses

695
75

42
200

42
365
//
barrels

445
285
barrel

320
415
barrel
//
arrivee
0
0
//