physique
100
100
11111111111111111111111111101111111111111111111111
11111111111111111111111111101111111111111111111111
11111111111111011101111111101111111111111111111111
11111111111011000001111111101111111111111111111111
11111111111000000001111111100000000000011111111111
11111111111000000000111110000000000000011111111111
11111111111000000000000000000000000000011111111111
11111111111000000000000000000000000000011111111111
11111111111000000000000000000000000000011111111111
11111111111000000000000000000000000000011111111111
11111111111000000000000000000000000000011111111111
11111111111111111110000000000000000000011111111111
11111111111111111110000000000000000000011111111111
11111111111111111110000000000000000000011111111111
11111111111111111111100000000000000000011111111111
11111111111111111111100000000000000000000001111111
11000000000000000011100000000000000000000001111111
11011111111111100011100011110000000000000001111111
11011111111111100011000011110000000000001111111111
11011111111111100011000011110000000000011111111111
11011111111111100011000011110000000000011111111111
11011111111111100000000000000000000000111111111111
11011111111111100000000000000000000001111111111111
11011111111111100000000000000000011111111111111111
11011111111111100000000000000000011111111111111111
11011111111111100000000000000000011111111111111111
11011111111111100000000000000000011111111111111111
11011111111111100000000000000000011111111111111111
11011111111111100000000000000000011111111111111111
11011111111111100000000000000000011111111111111111
11011111111111100000000000000000011111111111111111
11011111111111100000000000000000011111111111111111
11011111111111100000000000000000011111111111111111
11011111111111100000000011111100011111111111111111
11011111111111111111000011111100011111111111111111
11011111111111111111000011111100011111111111111111
11011111111111111111000011111100011011111111111111
11011111111111111111000011111100011111111111111111
11011111111111111111000011111100011111111111111111
11011111111111111111000011111100011111111111111111
11011111111111111111000011111100011111111111111111
11011111111111111111000011111100011111111111111111
11011111111111111111000011111100011111111111111111
11011111111111100000000011111100011111111111111111
11000000000000000000000011111100001111111111111111
11000111100000000000000011111100001111111111111111
11000111100000000000000011111100001111111111111111
11000111100000000000000011111100001111111111111111
11000111100000000000000000000000001111111111111111
11000111100000000000000000000000001111111111111111
11111111100000000000000000000000001111110000000000
11111111100000000000000000000000000000000000000000
11111111100000000000000000000000000000000000000000
11111111100000000000000000000000000000000000000000
11111111100000000000000011111100001111111100000000
11111110000000000000000011111100001111111100001111
11111110011110000000000011111111111111111100001111
11111110011110000000000011111111111111111100001111
11111110000011111100000011101111111111111100001111
11111110000011111100000011111111111111111100001111
11111110000000111011111111111111111111111100001111
11111000000000111011111111111111111111111100001111
11111000000000111011111111111111111111111100001111
11111000000000111011111111111111111111111100001111
11000000000000000011111111111111111111111100001111
11000111111111111111000011111111111111111100001111
11000111111111111111000011111111111111111100001111
11000111111111111111000011110000111111111100001111
11000111111111111111000011110000111111111100001111
11000111111111111111000011110000001111111100001111
11000111111111111111000011110000001111111100001111
11000111111111111111000011110000001111111100001111
11000111111111111111000011110000001111111100000000
11100111111111110111000011110000001111111100000000
11100111111111111111000011110000001111111100000000
11000111111111111111000000000000000000000000000000
11000111111111111111000000000000000000000000000000
11000000001110000000000000000000000111111111111111
11000000000000000000000000000000000111111111111111
11000000000000000000000000000000000111111111111111
11000000000000000000000000000000000111111111111111
11000000000000000000000000000000000111111111111111
11100000000000000000000000000000000111111111111111
11100000000000000000000000000000011111111111111111
11100000000000000000000000000000011111111111111111
11100000000000000000000000000001111111111111111111
11100000000000000000000000000001111111111111111111
11100000000000000000000000000111111111111111111111
11111111111000000000000000000111111111111111111111
11111111111111000000000000000111111111111111111111
11111111111111000000000000000111111111111111111111
11111111111111000000000000011111111111111111111111
11111111111111000000000000011111111111111111111111
11111111111111100000000000011111111111111111111111
11111111111111100000000000011111111111111111111111
11111111111111111100000000011111111111111111111111
11111111111111111100000000011111111111111111111111
11111111111111110100000000011111111111111111111111
11100000011111000000000000011111111111111111111111
11100000000000000000000000011111111111111111111111
11111111111111111111111111111111111111111111111111
//
spawn
160
40
0
0
100
0

160
40
0
0
100
0
new

160
100
0
0
100
0

160
100
0
0
100
0
new
//
caisses

1
1

2
42
//
barrels

1
1
barrel

42
42
barrel
//