PONEYYYYYYYYYYYYYY
0
400
240
physique
50
31
00001111111111111111111111111111111111111111110001
00111100101000000001000000000000000000000111110001
00110000000000000111000000000011111100000111110001
00100000000000000100000000000011111100000111110001
11100000000000011100000000000010000100000111110001
10000000000000010000000000000010000100000111110000
10000000000000010000000000000010000100000111110001
11000000000000010000000000000011100100000111110001
01000000000000010000000000000111100100000111110001
01000000000000010000000000000111100111000111110001
01110000000000010000000000000101100001000111110001
11110000000000011111111111111100000001111111110001
11111101100000000000000000000000000001111111110001
00000000000000000000000000000000000000000111110001
00000000000000000000011100111110000000000111110011
00000000000000000000011100111110000000000001110011
00000000000001111100011100111110000000000001110011
00111100000001111100000000111110000001111000000011
00111110000001111100000000000010000001111000000011
00111110000000000000111100111000000111111110010011
00000000000000000000111100111000000111111110010001
00000000000000000000111100111000000111001111110001
00000000000000000000100000000000000101111111110001
00000000000000000000000000000000011101111111110001
00000111111111000000000000000000011111111111011111
11111100000001111111111000111111111111111111111111
10000000000001111111111000111000000000000000000000
10001111111111000000000000001000000000000000000000
11101001000100000000000000001000000000000000000000
11111100000000000000000000001000000000000000000000

eau
00000000111111111111111111111111111111111111110000
00000000000000000111111111111111111111111111110000
00000000000000000111111111111111111111111111110000
00000000000000011111111111111110000111111111110000
00000000000000011111111111111110000111111111110000
00000000000000011111111111111110000111111111110000
00000000000000011111111111111111100111111111110000
00000000000000011111111111111111100111011111110000
00000000000000011111111111111111100111111111110000
00000000000000011111111111111101100111101101110000
00000000000000011111111111111100000001111111110000
00000000000000000000000000000000000001111111110000
00000000000000000000000000000000000000000111110000
00000000000000000000000000111110000000000111110000
00000000000000000000000000111110000000000001110000
00000000000001111100000000111110000000000001110011
00111110000001111100000000111110000001111000000011
00111110000001111100000000000010000001011000000011
00111110000001000000111100000000000111111110000011
00000000000000000000111100000000000111111110010011
00000000000000000000111100000000000111111111110000
00000000000000000000100000000000000111111111110000
00000111111111000000000000000000011111111111110000
00000111111111000000000000000000011111111111110000
00000111111111000000001000100000000000000000000000
00000111111111000000001000100000000000000000000000
00000111111111100000001000100000000000000000000000
00001111111111100000001000100000001110000000000000
00001000000000000000000000000000001110000000000000
00000000000000000000000000000000000000000000000000

//
spawn
100
100
0
0
100
10

150
100
0
1
100
10
new
//
caisses

250
30

635
210

500
250
//
barrels

115
303
barrel

490
383
barrel

225
175
barrel
//
arrivee
0
0
//
bossentry
144
445
//