physique
50
30
11111111111111111111111111111111111111111111110001
11111100101000000111111111111111111111111111110001
11110000000000000111111111111111111111111111110001
11100000000000011111111111111111111111111111110001
11100000000000011111111111111110000111111111110001
10000000000000011111111111111110000111111111110001
10000000000000011111111111111111100111111111110001
11000000000000011111111111111111100111111111110001
11000000000000011111111111111111100111111111110001
11000000000000011111111111111111100111111111110001
11110000000000011111111111111101100111111111110001
11111100000000011111111111111100000001111111110001
11111111100000000000000000000000000001111111110001
00000000000000000000000000111110000000000111110001
00000000000000000000011100111110000000000111110001
00000000000001111100011100111110000000000001110011
00111110000001111100011100111110000001111001110111
00111110000001111100000000111110000001111000000111
00111110000001111100111100000000000111111110000111
00111110000001000000111100111000000111111110010111
00000000000000000000111100111000000111111111110001
00000000000000000000111100111000000111111111110001
00000111111111000000100000000000011111111111110001
00000111111111000000000000000000011111111111110001
00000111111111000000001000100000011111111111111111
11111111111111111111111000111111111111111111111111
11111111111111111111111000111111111111111111111111
11111111111111100000001000101111111111111111111111
11111001111100000000000000001111111111111111111111
11111100000000000000000000001111111111111111111111
//
spawn
160
40
0
0
100
0

160
40
0
0
100
0
new

160
100
0
0
100
0

160
100
0
0
100
0
new
//
caisses

1
1

2
42
//
barrels

1
1
barrel

42
42
barrel
//