00000000000000000000000000000000000000000000000000
00000000000000000000000000000000000000000000000000
00000000000000000000000000000000000000000000000000
00000000000000000000000000000000000000000000000000
00000000000000000000000000000000000000000000000000
00000011111111111110000000111111111100000000000000
00000011111111111111111111111111111100000000000000
00000011111001111100000000000000111100000000000000
00000011111000000000000000000000011100000000000000
00000010110000000000000000000000001100000000000000
00000010110000000000000000000000000100000000000000
00000010000000000000000000000000000100000000000000
00000010000000000000000000000000000100000000000000
00000010000000000000000000000000000100000000000000
00000010000000000000000000000000000100000000000000
00000010000000000000000000000000000100000000000000
00000010000000000000000000000000000100000000000000
00000010000000000000000000000000000100000000000000
00000010000000000000000000000000000100000000000000
00000010000000000000000000000000000100000000000000
00000010000000000000000000000000000100000000000000
00000010000000000000000000000000000100000000000000
00000010000000000000000000000000000100000000000000
00000010000000000000000000000000000100000000000000
00000010000000000000000000000000000010000000000000
00000010000000000000000000000000000011000000000000
00000010000000000000000000000000000011100000000000
00000010000000000000000000000000000000010000000000
00000010000000000000000000000000000000010000000000
00000010000000000000000000000000000000010000000000
