PONEYYYYYYYYYYYYYY
4
400
240
physique
50
31
00000000000000000000000000000000000000000000000000
00000000000000000000000000000000000000000000000000
00000000000000000000000000000000000000000000000000
00000000000000000000000000000000000000000000000000
00000000000000000000000000000000000000000000000000
00000011111111111111111111110000000000000000000000
00000011111111111111111111111111111000000000000000
00000011101000000000000000000000111100000000000000
00000010111000000000000000000000011100000000000000
00000010110000000000000000000000001100000000000000
00000010000000000000000000000000000100000000000000
00000010000000000000000000000000000100000000000000
00000010000000000000000000000000000100000000000000
00000010000000000000000000000000000100000000000000
00000010000000000000000000000000000100000000000000
00000010000000000000000000000000000100000000000000
00000010000000000000000000000000000100000000000000
00000010000000000000000000000000000100000000000000
00000010000000000000000000000000000100000000000000
00000010000000000000000000000000000100000000000000
00000010000000000000000000000000000100000000000000
00000010000000000000000000000000000100000000000000
00000010000000000000000000000000000111110000000000
00000010000000000000000000000000000111110000000000
00000010000000000000000000000000000010110000000000
00000010000000000000000000000000000011110000000000
00000010000000000000000000000000000000010000000000
00000010000000000000000000000000000000010000000000
00000010000000000000000000000000000000010000000000
00000010000000000000000000000000000000010000000000
00000011111111111111111111111111111111110000000000

eau
00000000000000000000000000000000000000000000000000
00000000000000000000000000000000000000000000000000
00000000000000000000000000000000000000000000000000
00000000000000000000000000000000000000000000000000
00000000000000000000000000000000000000000000000000
00000011111111111111111111110000000000000000000000
00000011111111111111111111111111111000000000000000
00000011101000000000000000000000111100000000000000
00000010111000000000000000000000011100000000000000
00000010110000000000000000000000001100000000000000
00000010000000000000000000000000000100000000000000
00000010000000000000000000000000000100000000000000
00000010000000000000000000000000000100000000000000
00000010000000000000000000000000000100000000000000
00000010000000000000000000000000000100000000000000
00000010000000000000000000000000000100000000000000
00000010000000000000000000000000000100000000000000
00000010000000000000000000000000000100000000000000
00000010000000000000000000000000000100000000000000
00000010000000000000000000000000000100000000000000
00000010000000000000000000000000000100000000000000
00000010000000000000000000000000000100000000000000
00000010000000000000000000000000000111110000000000
00000010000000000000000000000000000111110000000000
00000010000000000000000000000000000010110000000000
00000010000000000000000000000000000011110000000000
00000010000000000000000000000000000000010000000000
00000010000000000000000000000000000000010000000000
00000010000000000000000000000000000000010000000000
00000010000000000000000000000000000000010000000000
00000011111111111111111111111111111111110000000000



//
spawn
-2000
-2000
-100
-100
-50
-50
new
//
caisses

595
435

245
135

345
150

345
445
//
barrels

191
255
barrel

191
400
barrel

480
255
barrel

480
400
barrel
//
arrivee
0
0
//
bossentry
0
0
//